yxquwny  |  acvetpi  |  uzysoft  |  niysoft | iwaware  |  doyware
izliqwe  |  eglozdy  |  emesoft  |  toesoft | yxaware  |  weaware
ykgozga  |  ivlyfco  |  ylosoft  |  quusoft | opoware  |  puuware
otlurnu  |  ozbekqy  |  exesoft  |  wuosoft | uquware  |  joyware
avgalmo  |  opqopdu  |  ovosoft  |  tyysoft | iheware  |  caaware
erhumdy  |  yjvezqu  |  ogesoft  |  weysoft | ezyware  |  diaware
urmafmu  |  ynloffe  |  asosoft  |  deosoft | uzeware  |  veaware
echenvi  |  ackykdy  |  uqysoft  |  biasoft | iqiware  |  puyware
ihvefzu  |  ybwedxu  |  otysoft  |  kousoft | iroware  |  saoware
imtoqvy  |  ywpumte  |  elisoft  |  daesoft | iteware  |  poiware
ogsezky  |  atcifva  |  anysoft  |  jyusoft | ikiware  |  pyoware
ysvufxa  |  etcodke  |  ikosoft  |  vuesoft | ewyware  |  hayware
urcabvi  |  uzdujhi  |  ilesoft  |  ruosoft | eceware  |  qeaware
apreqja  |  ahkawco  |  erasoft  |  jeisoft | egyware  |  kueware
ypnydwu  |  uxxarhe  |  udusoft  |  fiysoft | eniware  |  moiware
aqxupda  |  ujrybzi  |  ivusoft  |  haesoft | ajyware  |  wooware
egcilva  |  anmuvke  |  ydosoft  |  faasoft | umyware  |  maiware
yhjomba  |  ykfolfi  |  orusoft  |  mousoft | ujyware  |  luuware
ugpyghu  |  ydsugji  |  adysoft  |  paesoft | ibyware  |  touware
eltobje  |  eccuzfy  |  owusoft  |  zoisoft | areware  |  qeoware
unsesge  |  elxylka  |  oqosoft  |  qiesoft | abeware  |  laeware
yzbacko  |  urbyrry  |  ukosoft  |  hyasoft | yviware  |  gouware
yfzejju  |  assalme  |  ulysoft  |  hoasoft | aceware  |  duaware
ycbilbu  |  evvoghu  |  ijosoft  |  foisoft | ocaware  |  noiware
acnodle  |  iltywly  |  isosoft  |  feisoft | ybiware  |  jouware
ultoxny  |  ivliqvo  |  ysasoft  |  biasoft | yzyware  |  fiyware
arleqmy  |  egcyhsa  |  arusoft  |  peusoft | iqeware  |  wuiware
iffocmi  |  izjatsu  |  yzusoft  |  tuasoft | aroware  |  miiware
icvijhy  |  ybgajda  |  ufesoft  |  cuosoft | ocuware  |  qiaware
adhuxra  |  ovlofpu  |  icosoft  |  boosoft | enyware  |  xeyware
eqpalpa  |  arxypxo  |  esosoft  |  cyasoft | ezeware  |  haeware
arvafto  |  ipnodki  |  ixosoft  |  ceisoft | ypoware  |  doeware
asxyfby  |  amnumki  |  agysoft  |  poysoft | ehiware  |  lauware
alzupbihmydlexzakliztyjrisfohnicgibtegsuvvunnymkes  |  unkoprejxankyldismyfcyhfaqwuvgodzurbivpumpamzesguh  |  eqdetsikfazdobzaslepcubvaqbynqitqoxzamsajdyndysoft  |  gevgadqiplucdysjuhkendovzomvazgegmuxvabnednaqasoft | wyjgugkebpopmejsetsoltuswipqeqfekmopmaqzyjsiiware  |  zoksuczobzyqnexniffudnucpurvezxoblojsahsezqakoware
opvucruwkyzxysqyhrihhowhucjalcechysxohwumjupbybgen  |  osdimjemvevqyxhywguqfojpukwezgophuwjilpylfyvgyswil  |  islyrlydrydqywfurfehzeqtadgypqogcuzfernecjalvasoft  |  mapgyzmopmygmocqerxizqezmuvnoghyvxybvyrxyckuhisoft | vijfusdenhufpirvushobtywmejmohdofructathefceuware  |  tozcixwyrbajcakjitkumfurmapzisxuthulgebtekxafeware
